######################
#X#   #     #    #   #
# ## ####### # # ### #
#  #       #   #   # #
## ### ### # ### ### #
#      #     #      @#
######################
