#################
#O          #   #
######### # ### #
#   #     #   # #
### # ##### # # #
#   #     # #   #
# ####### # ### #
#         #     #
### ####### #####
#   #     #     #
# ### ### ### # #
#     #       # #
##### ######### #
#     #   #     #
##### ### #######
#              X#
#################
