#############################################
#O#               # #       #   #       # # #
# # ####### # ### # ### ### # ### # # # # # #
#   #   #   # # #   #   #   # #   # #       #
##### ####### # ### # ### ### # ##### # #####
#   #   #   # # #     # #   # #   #   # #   #
# # ### ### ### ### # # # ### ### # ### # # #
# #   #   #     # # #   #     #   # #   # # #
# ### ### ##### # ### ### # ### ### ##### # #
# #   #   #   # #   #   # #   #   #     # # #
# # ### # # # # ### # ##### # # # ### # ### #
# #   # #   # #   #   #     #   #   # #   # #
# ##### ### ### ##### ##### ### ### # # # # #
# #   #   #   # #   # #   # #   #   #   # # #
# ### ### ### # # # ### # # ### ### ##### ###
#   #   #   # # #   #   # # #   #   #   #   #
### ### ##### # ### ##### # ### ### ### # ###
#   #   #  X# # #       # # #   # #   # #   #
# ### ### ### # ##### # # # ### # # ### ### #
# #   #   #   #   #   # # #   # # #   # # # #
# # ### ### ### ### ### ### ### # ##### # # #
#   #   #       # # #   # #   # # #   #   # #
##### ### # ### # # ### # ### # ### # ##### #
#   #   # # #   # #   # #   # #   # # #   # #
# ### ### ### ##### ### ##### ### ### # # # #
# #   #   #   #   #   # #     #   #   # # # #
# # ### ### ##### ### # # ### ### ### ### # #
#   # #   #           # #   # #   #   #   # #
### # ### ### ### ### # ##### # # ### ### # #
#   #   #   # # #   # #   #   # # # #   # # #
# ##### ### ### # ### ### ##### ### ### ### #
#   # #   #   # #   #   #   #   #   # #   # #
# ### # ### ### ### # ##### ### # ### # ### #
#     #   # #   #   # #       # #   # # #   #
# ### ##### # ##### # # # ### ### # # ### ###
# #   #     #   #   #   # #     # # #   # # #
# ### ### ##### ### ##### ### # ### # ### # #
# #     #   #   #   #     #   # #   # #   # #
# ##### ### # ##### ### ### ### ### ##### ###
#     #     #   #     #   #   #             #
#############################################
