###########################
#             #   #     # #
# ####### ### ### ### # # #
# #     #   #   #   # # # #
# # ### ### # ### ### ### #
# #   #   # # #   # #   # #
# # ### ### ### ### # ### #
# #   #   #   #   # #   # #
# ### ### ### # ### ### # #
#   #   # #   #   #   #   #
# ### ### ### ### ### ### #
# #   #   # # # #   #   # #
# ### # ### # # # ### # # #
#   # #   #   X   #   #   #
# ### # ### # # # ### # # #
# #   #   # # # #   #   # #
# ### ### ### ### ### ### #
#   #   # #   #   #   #   #
# ### ### ### # ### ### # #
# #   #   # # # #   # # # #
# # ### ### ### ### # ### #
#   # #       # #   #   # #
# ### ### ### ### ### ### #
# #   #   # # #   #   #   #
# ### # ### # ### ### # ###
#     #     #     #      O#
###########################
