#######################
#O  #     #   #     # #
### # ### ### # ### # #
#   # #   #   # #   # #
# ### ### # ### # ### #
# #   #   # #   #   # #
# # ### ### ### ### # #
# #   # #   # # #   # #
# ### # # ### # # ### #
#   # # #   # # #   # #
### # # ### # # ### # #
#   #   # X #   #   # #
### # # ### # # ### # #
#   # #   # # #   #   #
# ### # ### # ### ### #
# #   #   # #   #   # #
# # ### ### ### ### # #
# #   # #   # # #   # #
# ### # # ### # # ### #
#   # #   #   # #   # #
# ### # ### ### # ### #
#     #     #     #   #
#######################
