##################
#O      #   #    #
# ####### # ######
#         #      #
##### # ### #### #
#   # #   #    #X#
##################
