###############
#@#     #     #
# # ### # ### #
# #   #   #   #
# ### ##### # #
#     #   # # #
##### ### # # #
#     #   #   #
# ### ##### ###
# #     #     #
# # ### # ### #
# # #   #   # #
# # # ##### # #
#   #       #X#
###############
