######################
#@    #           #  #
# ## ##### # ### ### #
#  #       #   #     #
## ####### ##### #####
#      #     #      X#
######################