#####################################
#O    #       # #     #   # # # # # #
# # # # ##### # # # ### # # # # # # #
#   #       #     # #   # #   #   # #
# ######### ### ### ### # # # # ### #
#   #       #   # #     # # # #   # #
# # # ####### # # # ### # ### ### # #
# # # #     # #   # # # # # #   # # #
# # # # ### # ##### # # # ### ### # #
#   #   # # # #   #   # #         # #
# ### ### # # # # ########### ### # #
#     # # # #   # #       #     # # #
# ### # # # ##### # ##### ### ### ###
# #   #   #     # # #   #   #   #   #
# # ######### ### # # ##### ### ### #
# # #       # #   # #   # #   #   # #
# ### ##### # # ### ### # ### # # # #
#   #   #   # #   #     # #   # # # #
# ### ### ### # ### ##### # ### # ###
#   #X#   #   #   #       #   # # # #
### ### ##### ######### ### ### # ###
# #   # #     #     #   #   #   # # #
# # ### # ##### ### # ### ### ### # #
# # #   # #   # # # #   #   # #   # #
# # ### ### # # # ##### ### ### ### #
# #   #     # # #   #     #   # #   #
# ### ####### ### ### ####### # ### #
#   #       #   # #   # #   # #     #
# ##### ### ### ### ### ### # ##### #
#     #   #   #     #               #
#####################################
