######################
#X#   #     #    #   #
# ## ####### # # ### #
#  #       #   #   # #
## ### ### # ### ### #
#      #     #      O#
######################
