#############################################
#@#   #     #     #     #   #   #     # # # #
# # # # ### # ### # ### ### # ### # # # # # #
#   #         # #   #   #   # #   # #   #   #
######### ### # ##### ### ### # ##### # #####
#       #     #       # #   # #   #   # #   #
# # ### ####### ### # # # ### ### # ### # # #
# #   #         # # #   # #   #   # #   # # #
# ### ########### ### ### # ### ### ### # # #
# #   #         #   #   # #   #   # #   # # #
# # ### #   # # ### # ##### # ### ### # ### #
# #   # #   # #   #   #     #   #   # #   # #
# ##### ### ### # ### ##### ### ### # # # # #
# #   #   #   ###   # #   # #   #   #   # # #
# ### ### ### # # # ### # # ### ### ##### ###
#   #       # # #   #   # # #   #   #       #
### ### ####### ##### ### # ### ### ### # ###
#       #       #     #   # #   # #   # # # #
# ### ### ### # ##### # # # ### # # ### ### #
# #   #   #   #       # # #   # # #   # # # #
# # ### ### ### ####### ### # # # ## ## # # #
#   #   # #   # # # #   #     # # #   #   # #
# ### ### # ### # # ### # ### # ### # # ### #
#   #   # # #   # #   # #   # #   # # #   # #
# ##### ### ### ##### ### ##### ### ### # # #
# #   #   #   #       # #     #   #   # # # #
# # ### ### ######### # # ### ### ### ### ###
#   # #   #   #       # #   # #   #   #     #
### # ### ### ### ### # ##### # # # # ### # #
#   #   #   #   #   # #       # # # #   # # #
# ### # ### ### # ### ### ##### ### ### ### #
#   # #   #   # #   #   #   #   #   # #   # #
# ### # ### ### ### # ##### ### # ### # ### #
# #   #   # #   #   #     #   #   # # # #   #
# ### ## ## # ##### ### # ### ##### # ### ###
# #   #   # #   #   #   # #   #     #   # # #
# ### ### ##### ### # ### ### # ### # ### # #
# #     #   #   #   #     #   # ###       # #
# ##### ### # ##### ### ### ###    ##########
#       #     #       #       #  #          #
###########################################X#
