######################
#O    #           #  #
# ## ##### # ### ### #
#  #       #   #     #
## ####### ##### #####
#      #     #      X#
######################