##################
#@      #   #    #
# ####### # ######
#         #      #
##### # ### #### #
#   # #   #    #X#
##################
